XXXXXXXXXXXXXXXXXXXXXXXXXXX
X===O========X========O===X
X=XXXX=XXXXX=X=XXXXX=XXXX=X
X=XXXX=XXXXX=X=XXXXX=XXXX=X
X=XXXX=XXXXX=X=XXXXX=XXXX=X
XP========================X
X=XXXX=XX=XXXXXXX=XX=XXXX=X
X=XXXX=XX=XXXXXXX=XX=XXXX=X
X_==2==XX=========XX======X
XXXXXXXXXXXXXXXXXXXXXXXXXXX